22
10
1111111111111111111111
1000000000000000000001
1000000000000000000001
1000000000000000000001
1000002000000000000001
1000000000000000000001
1000000001111110000001
1000000001000000000001
1000000001000000000001
1111111111111111111111